"a" = (/turf/closed/mineral/random/volcanic,/area/space)
"b" = (/turf/open/lava/smooth/lava_land_surface,/area/space)
"c" = (/turf/open/floor/plating/asteroid/basalt/lava_land_surface,/area/space)

(1,1,1) = {"
bbbbbbbbbbbbbbbbbbbbbbbbbbbbbbbbbbbbbbbbbbbbbbbbbbbbbbbbbbbbbbbbbbbbbbbbbbbbbbbbbbbbbbbbbbbbbbbbbbbb
bbbbbbbbbbbbbbbbbbbbbbbbbbbbbbbbbbbbbbbbbbbbbbbbbbbbbbbbbbbbbbbbbbbbbbbbbbbbbbbbbbbbbbbbbbbbbbbbbbbb
bbbbbbbbbbbbbbbbbbbbbbbbbbbbbbbbbbbbbbbbbbbbbbbbbabbbbbbbbbbbbbbbbbbbbbbbbbbbbbbbbbbbbbbbbbbbbbbbbbb
bbbbbbcccccccccccccccccccccccccccccccccccccccccccaccccccccccccccccccccccccccccccccccccccccccccbbbbbb
bbbbbccccccccccccccccccccccccccccccccccccccccccccacccccccccccccccccccccccccccccccccccccccccccccbbbbb
bbbbcccccccccccccccccccccccccccccccccccccccccccccaccccccccccccccccccccccccccccccccccccccccccccccbbbb
bbbccccccccccccccccccccccccccccccccccccccccccccccacccccccccccccccccccccccccccccccccccccccccccccccbbb
bbaaaaaaaaaaaaaaaaaaaaaaaaaaaaaaaaaaaaaaaaaaaaaaaaaaaaaaaaaaaaaaaaaaaaaaaaaaaaaaaaaaaaaaaaaaaaaaaabb
bbbccccccccccccccccccccccccccccccccccccccccccccccacccccccccccccccccccccccccccccccccccccccccccccccbbb
bbbccccccccccccccccccccccccccccccccccccccccccccccacccccccccccccccccccccccccccccccccccccccccccccccbbb
bbbccccccccccccccccccccccccccccccccccccccccccccccaccccccccccccccccccccccccccccccccccbcccbbcccccccbbb
bbbccccccccccccccccccccccccccccccccccccccccccccccaccccccccccccccccccccccccccccccccccbccccbcccccccbbb
bbbccccccccccccccccccccccccccccccccccccccccccccccaccccccccccccccccccccccccccccccccccbcccbccccccccbbb
bbbccccccccccccccccccccccccccccccccccccccccccccccaccccccccccccccccccccccccccccccccccbbbcbbcccccccbbb
bbbccccccccccccccccccccccccccccccccccccccccccccccacccccccccccccccccccccccccccccccccccccccccccccccbbb
bbbccccccccccccccccccccccccccccccccccccccccccccccacccccccccccccccccccccccccccccccccccccccccccccccbbb
bbbccccccccccccccccccccccccccccccccccccccccccccccacccccccccccccccccccccccccccccccccccccccccccccccbbb
bbbccccccccccccccccccccccccccccccccccccccccccccccacccccccccccccccccccccccccccccccccccccccccccccccbbb
bbbcccccccccccccccccccccccccccccccbbbbbbbbbbbbbbbbbbbbbbbbbbbbbbbccccccccccccccccccccccccccccccccbbb
bbbccccccccccccccccccccccccccccccbbbbbbbbbbbbbbbbbbbbbbbbbbbbbbbbbcccccccccccccccccccccccccccccccbbb
bbbcccccccccccccccccccccccccccccbbbbbbbbbbbbbbbbbbbbbbbbbbbbbbbbbbbccccccccccccccccccccccccccccccbbb
bbbcccccccccccccccccccccccccccccbbbbbccccccccccccaccccccccccccbbbbbccccccccccccccccccccccccccccccbbb
bbbcccccccccccccccccccccccccccccbbbbcccccccccccccacccccccccccccbbbbccccccccccccccccccccccccccccccbbb
bbbcccccccccccccccccccccccccccccbbbccccccccccccccaccccccccccccccbbbccccccccccccccccccccccccccccccbbb
bbbcccccccccccccccccccccccccccccbbbccccccccccccccaccccccccccccccbbbccccccccccccccccccccccccccccccbbb
bbbcccccccccccccccccccccccccccccbbbccccccccccccccaccccccccccccccbbbccccccccccccccccccccccccccccccbbb
bbbcccccccccccccccccccccccccccccbbbccccccccccccccaccccccccccccccbbbccccccccccccccccccccccccccccccbbb
bbbcccccccccccccccccccccccccccccbbbccccccccccccccaccccccccccccccbbbccccccccccccccccccccccccccccccbbb
bbbcccccccccccccccccccccccccccccbbbccccccccccccccaccccccccccccccbbbccccccccccccccccccccccccccccccbbb
bbbcccccccccccccccccccccccccccccbbbccccccccccccccaccccccccccccccbbbccccccccccccccccccccccccccccccbbb
bbbcccccccccccccccccccccccccccccbbbccccccccccccccaccccccccccccccbbbccccccccccccccccccccccccccccccbbb
bbbcccccccccccccccccccccccccccccbbbccccccccccccccaccccccccccccccbbbccccccccccccccccccccccccccccccbbb
bbbcccccccccccccccccccccccccccccbbbccccccccccccccaccccccccccccccbbbccccccccccccccccccccccccccccccbbb
bbbcccccccccccccccccccccccccccccbbbccccccccccccbbbbbccccccccccccbbbccccccccccccccccccccccccccccccbbb
bbbcccccccccccccccccccccccccccccbbbccccccccccccbbbbbccccccccccccbbbccccccccccccccccccccccccccccccbbb
bbaaaaaaaaaaaaaaaaaaaaaaaaaaaaaabbbaaaaaaaaaaaabbcbbaaaaaaaaaaaabbbaaaaaaaaaaaaaaaaaaaaaaaaaaaaaaabb
bbbcccccccccccccccccccccccccccccbbbccccccccccccbbbbbccccccccccccbbbccccccccccccccccccccccccccccccbbb
bbbcccccccccccccccccccccccccccccbbbccccccccccccbbbbbccccccccccccbbbccccccccccccccccccccccccccccccbbb
bbbcccccccccccccccccccccccccccccbbbccccccccccccccaccccccccccccccbbbccccccccccccccccccccccccccccccbbb
bbbcccccccccccccccccccccccccccccbbbccccccccccccccaccccccccccccccbbbccccccccccccccccccccccccccccccbbb
bbbcccccccccccccccccccccccccccccbbbccccccccccccccaccccccccccccccbbbccccccccccccccccccccccccccccccbbb
bbbcccccccccccccccccccccccccccccbbbccccccccccccccaccccccccccccccbbbccccccccccccccccccccccccccccccbbb
bbbcccccccccccccccccccccccccccccbbbccccccccccccccaccccccccccccccbbbccccccccccccccccccccccccccccccbbb
bbbcccccccccccccccccccccccccccccbbbccccccccccccccaccccccccccccccbbbccccccccccccccccccccccccccccccbbb
bbbcccccccccccccccccccccccccccccbbbccccccccccccccaccccccccccccccbbbccccccccccccccccccccccccccccccbbb
bbbcccccccccccccccccccccccccccccbbbccccccccccccccaccccccccccccccbbbccccccccccccccccccccccccccccccbbb
bbbcccccccccccccccccccccccccccccbbbccccccccccccccaccccccccccccccbbbccccccccccccccccccccccccccccccbbb
bbbcccccccccccccccccccccccccccccbbbccccccccccccccaccccccccccccccbbbccccccccccccccccccccccccccccccbbb
bbbcccccccccccccccccccccccccccccbbbbcccccccccccccacccccccccccccbbbbccccccccccccccccccccccccccccccbbb
bbbcccccccccccccccccccccccccccccbbbbbccccccccccccaccccccccccccbbbbbccccccccccccccccccccccccccccccbbb
bbbcccccccccccccccccccccccccccccbbbbbbbbbbbbbbbbbbbbbbbbbbbbbbbbbbbccccccccccccccccccccccccccccccbbb
bbbccccccccccccccccccccccccccccccbbbbbbbbbbbbbbbbbbbbbbbbbbbbbbbbbcccccccccccccccccccccccccccccccbbb
bbbcccccccccccccccccccccccccccccccbbbbbbbbbbbbbbbbbbbbbbbbbbbbbbbccccccccccccccccccccccccccccccccbbb
bbbccccccccccccccccccccccccccccccccccccccccccccccacccccccccccccccccccccccccccccccccccccccccccccccbbb
bbbcccccccbccccbcccccccccccccccccccccccccccccccccacccccccccccccccccccccccccccccccccccccccccccccccbbb
bbbcccccccbcccbbcccccccccccccccccccccccccccccccccacccccccccccccccccccccccccccccccccccccccccccccccbbb
bbbcccccccbccccbcccccccccccccccccccccccccccccccccacccccccccccccccccccccccccccccccccccccccccccccccbbb
bbbcccccccbccccbcccccccccccccccccccccccccccccccccacccccccccccccccccccccccccccccccccccccccccccccccbbb
bbbcccccccbbbccbcccccccccccccccccccccccccccccccccacccccccccccccccccccccccccccccccccccccccccccccccbbb
bbbccccccccccccccccccccccccccccccccccccccccccccccacccccccccccccccccccccccccccccccccccccccccccccccbbb
bbbccccccccccccccccccccccccccccccccccccccccccccccacccccccccccccccccccccccccccccccccccccccccccccccbbb
bbbccccccccccccccccccccccccccccccccccccccccccccccacccccccccccccccccccccccccccccccccccccccccccccccbbb
bbbaaaaaaaaaaaaaaaaaaaaaaaaaaaaaaaaaaaaaaaaaaaaaaaaaaaaaaaaaaaaaaaaaaaaaaaaaaaaaaaaaaaaaaaaaaaaaabbb
bbbccccccccccccccccccccccccccccccccccccccccccccccacccccccccccccccccccccccccccccccccccccccccccccccbbb
bbbbcccccccccccccccccccccccccccccccccccccccccccccaccccccccccccccccccccccccccccccccccccccccccccccbbbb
bbbbbccccccccccccccccccccccccccccccccccccccccccccacccccccccccccccccccccccccccccccccccccccccccccbbbbb
bbbbbbcccccccccccccccccccccccccccccccccccccccccccaccccccccccccccccccccccccccccccccccccccccccccbbbbbb
bbbbbbbbbbbbbbbbbbbbbbbbbbbbbbbbbbbbbbbbbbbbbbbbbabbbbbbbbbbbbbbbbbbbbbbbbbbbbbbbbbbbbbbbbbbbbbbbbbb
bbbbbbbbbbbbbbbbbbbbbbbbbbbbbbbbbbbbbbbbbbbbbbbbbbbbbbbbbbbbbbbbbbbbbbbbbbbbbbbbbbbbbbbbbbbbbbbbbbbb
bbbbbbbbbbbbbbbbbbbbbbbbbbbbbbbbbbbbbbbbbbbbbbbbbbbbbbbbbbbbbbbbbbbbbbbbbbbbbbbbbbbbbbbbbbbbbbbbbbbb
"}
